8 8
########
#.....##
#.#B..G#
#.P....#
#......#
#..B#..#
#G.....#
########
