10 8
.....#####
.#.#.#G..#
.....#G#.#
######G#.#
.P.B.B.B.#
.#.#.#.###
.......#..
########..
