10 10
..........
.........#
.........#
.........#
....B#G..#
..P......#
.........#
.........#
.........#
##########
