9 9
##......#
#..B....#
........#
.P.###G.#
....G...#
..B#.#..#
........#
........#
#########
