9 9
##.....##
#.#####.#
.#.....#.
.#.GBG.#.
.#.BGB.#.
.#.GBG.#.
.#.BGB.#.
.#..P..#.
#########
