10 8
.#####...#
.#..####..
.#.....##.
##.##...#.
#G.G#.PB#.
#...#.BB.#
#..G#....#
##########
