12 12
############
#..........#
#....G.....#
#....B.....#
#..###.....#
#.....P....#
#....B.....#
#....G.....#
#..........#
#..........#
#..........#
############