8 8
########
###...G#
#.B..#.#
#P.....#
#......#
#.B..#G#
###..###
########
