8 8
########
#......#
#.P.BG.#
#..#BG.#
#..#...#
#......#
#......#
########